WWWWWWWWWWWWWWWWWWW
W000000000W0000000W
W000000000W0000000W
W0WWWWWWW0W0WWWWW0W
W0W00000W000W00000W
W0000000W000W00000W
W000WWWWW0W0WWWWW0W
W0WWW00000W0000000W
00W0000000W0000000W
000000WWWWW0WWW0WWW
W000W00000W00W0000W
WWW0W00000W00WW000W
W000WW0WWWWW00WWWWW
W000W0000W0W000000W
W0WWW0000W0WW00000W
W00000W00000000W00W
W00000W00000000W00W
WWWWWWWWW0WWWWWWWWW
