WWWWWWWWW0WWWWWWWWW
W000000000W0000000W
W000000000W0000000W
WWWWW0WWWWWWWWWWW0W
W0W0000000W00000W0W
W0W0000000W00000W0W
W0W0WWWWW0W0WWWWW0W
W0W0W00000W0W00000W
00W0W00000W0W00000W
00W0W000W0W0W000W0W
W000W000W0W0W000W0W
W000WWWWW0W0WWWWW0W
W0W0W0000000W00000W
W0W0W0000000W00000W
WWWWW0WWWWWWWWW0WWW
W00000000000000000W
W00000000000000000W
WWWWWWWWWWWWWWWWWWW
